7 13
***********F*
*  ** *  ** *
** ** **    *
**       ****
* * * **   **
***  **    S*
*************